 11,417        25,394        94,094        25,394
 94,094        25,394        94,094        3,937
 94,094        3,937         11,417        3,937
 11,417        3,937         11,417        25,394
 0             0             0            -52,362
 0            -92,716        0            -101,181
 0            -101,181      -3,543        -101,181
-24,016       -101,181      -31,102       -101,181
-43,701       -101,181      -50,787       -101,181
-83,071       -101,181      -89,37        -101,181
 112,992       203,543       127,165       203,543
 112,992       203,543       112,992       218,504
 112,992       218,504       127,165       218,504
 127,165       218,504       127,165       203,543
 0             0             142,52        0
 110,63        220,472       129,921       220,472
 110,63        220,472       110,63        362,992
 110,63        362,992       108,268       362,992
 108,268       362,992       108,268       410,236
-62,598        88,583       -62,598        144,882
-62,598        88,583       -43,307        88,583
-43,307        88,583       -43,307        144,882
-43,307        144,882      -62,598        144,882
-55,118        207,087      -55,118        237,402
-55,118        237,402      -76,378        237,402
-76,378        237,402      -76,378        207,087
-76,378        207,087      -55,118        207,087
 102,362       146,063       133,465       146,063
 133,465       146,063       133,465       202,362
 133,465       202,362       102,362       202,362
 102,362       202,362       102,362       146,063
 142,52        0             142,63        417,673
 108,268       410,236       131,89        410,236
 142,52        417,913       107,48        417,913
 68,898        417,913      -16,929        417,913
-54,921        417,913      -89,37         417,913
-89,37        -101,181      -89,26         418,066
-87,992        411,22       -69,291        411,22
-69,291        411,22       -69,291        380,118
-69,291        380,118      -87,795        380,118
-87,992        380,118      -87,992        380,118
-87,992        380,118      -87,992        411,22
-83,465        375,197      -52,756        376,378
-52,756        376,378      -50,394        315,551
-50,394        315,551      -81,102        314,173
-81,102        314,173      -81,102        314,173
-81,102        314,173      -83,465        375,197
-72,835        314,37       -46,85         314,37
-46,85         314,37       -46,85         271,85
-46,85         271,85       -72,835        271,85
-72,835        271,85       -72,835        314,37
 53,346        410,039       59,055        391,535
 59,055        391,535       30,906        382,874
 30,906        382,874       25,197        401,378
 25,197        401,378       53,346        410,039
 6,102         406,496       13,386        403,543
 13,386        403,543       16,339        396,26
 16,339        396,26        13,386        388,976
 13,386        388,976       6,102         385,827
 6,102         385,827      -1,378         388,976
-1,378         388,976      -4,331         396,26
-4,331         396,26       -1,378         403,543
-1,378         403,543       6,102         406,496
 2,079         268,854      -89,26         268,854
 2,079         268,854       2,079         252,712
 2,079         253,106      -89,26         253,106
 30,512        192,323       30,512        151,181
 30,512        151,181      -10,63         151,181
-10,63         151,181      -10,63         192,323
-10,63         192,323       30,512        192,323
-26,772        151,3         4,528         151,3
 4,528         151,3         4,528         119,804
 4,528         119,804      -26,772        119,804
-26,772        119,804      -26,772        151,3
 1,968         268,504       3,346         268,11
 3,346         268,11        3,937         266,732
 3,937         266,732       3,346         265,354
 3,346         265,354       1,968         264,764
 1,968         264,764       ,591          265,354
 ,591          265,354       ,197          266,732
 ,197          266,732       ,591          268,11
 ,591          268,11        1,968         268,504
 1,968         256,496       3,346         256,102
 3,346         256,102       3,937         254,724
 3,937         254,724       3,346         253,346
 3,346         253,346       1,968         252,756
 1,968         252,756       ,591          253,346
 ,591          253,346       ,197          254,724
 ,197          254,724       ,591          256,102
 ,591          256,102       1,968         256,496
-10,236        256,496      -8,858         256,102
-8,858         256,102      -8,268         254,724
-8,268         254,724      -8,858         253,346
-8,858         253,346      -10,236        252,756
-10,236        252,756      -11,614        253,346
-11,614        253,346      -12,008        254,724
-12,008        254,724      -11,614        256,102
-11,614        256,102      -10,236        256,496
-10,236        268,307      -8,858         267,913
-8,858         267,913      -8,268         266,535
-8,268         266,535      -8,858         265,157
-8,858         265,157      -10,236        264,567
-10,236        264,567      -11,614        265,157
-11,614        265,157      -12,008        266,535
-12,008        266,535      -11,614        267,913
-11,614        267,913      -10,236        268,307
-32,087        255,315      -30,906        255,315
-30,906        255,315      -30,906        254,134
-30,906        254,134      -32,087        254,134
-32,087        254,134      -32,087        255,315
-52,165        201,772      -52,165        179,134
-52,165        179,134      -79,331        179,134
-79,331        179,134      -79,331        201,575
-79,331        201,575      -52,165        201,575
-56,89         200,394      -56,89         198,819
-56,89         198,819      -60,433        198,819
-60,433        198,819      -60,433        200,394
-60,433        200,394      -56,89         200,394
-78,74         198,819      -77,559        198,819
-77,559        198,819      -77,559        200,394
-77,559        200,394      -78,74         200,394
-78,74         200,394      -78,74         198,819
-78,74         179,134      -77,559        179,134
-77,559        179,134      -77,559        180,709
-77,559        180,709      -78,74         180,709
-78,74         180,709      -78,74         179,134
-60,433        181,693      -56,693        181,693
-56,89         181,693      -56,89         183,268
-56,89         183,268      -60,433        183,268
-60,433        183,268      -60,433        181,693
-59,449        84,449       -30,709        84,449
-30,709        84,449       -30,709        12,008
-30,709        12,008       -59,449        12,008
-59,449        12,008       -59,449        84,449
-32,086        12,588       -33,267        12,588
-32,086        12,588       -32,086        13,769
-33,267        12,588       -33,267        13,769
-33,267        13,769       -32,086        13,769
-56,889        12,588       -56,889        13,769
-56,889        12,588       -58,07         12,588
-58,07         12,588       -58,07         13,769
-58,07         13,769       -56,889        13,769
-58,267        58,06        -58,267        62,784
-58,267        62,784       -59,448        62,784
-59,448        62,784       -59,448        84,438
-59,448        84,438       -30,708        84,438
-30,708        84,438       -30,708        62,784
-30,708        62,784       -31,889        62,784
-31,889        62,784       -31,889        58,06
-31,889        58,06        -58,267        58,06
-42,126        153,543      -39,37         153,543
-39,37         153,543      -39,37         152,756
-39,37         152,756      -63,78         152,756
-63,78         152,756      -63,78         176,378
-63,78         176,378      -39,37         176,378
-39,37         176,378      -39,37         175,591
-39,37         175,591      -42,126        175,591
-42,126        175,591      -42,126        153,543
-39,37         175,591      -39,37         153,543
 98,228        144,685       124,606       144,685
 124,606       144,685       124,606       123,228
 124,606       123,228       98,228        123,228
 98,228        123,228       98,228        144,685
 102,559       144,685       105,709       144,685
 105,709       144,685       105,709       143,701
 105,709       143,701       102,559       143,701
 102,559       143,701       102,559       144,685
 119,488       144,685       122,638       144,685
 122,638       144,685       122,638       143,701
 122,638       143,701       119,488       143,701
 119,488       143,701       119,488       144,685
 119,488       124,213       122,638       124,213
 122,638       124,213       122,638       123,228
 122,638       123,228       119,488       123,228
 119,488       123,228       119,488       124,213
 102,559       124,213       105,709       124,213
 105,709       124,213       105,709       123,228
 105,709       123,228       102,559       123,228
 102,559       123,228       102,559       124,213
 102,362       146,063       102,362       147,244
 102,362       147,244       103,543       147,244
 103,543       147,244       103,543       146,063
 103,543       146,063       102,362       146,063
 98,819        127,559       98,819        141,339
 98,819        141,339       99,213        141,339
 99,213        141,339       99,213        127,559
 99,213        127,559       98,819        127,559
 102,362       201,181       102,362       202,362
 102,362       202,362       103,543       202,362
 103,543       202,362       103,543       201,181
 103,543       201,181       102,362       201,181
 132,284       201,181       132,284       202,362
 132,284       202,362       133,465       202,362
 133,465       202,362       133,465       201,181
 133,465       201,181       132,284       201,181
 132,284       146,063       132,284       147,244
 132,284       147,244       133,465       147,244
 133,465       147,244       133,465       146,063
 133,465       146,063       132,284       146,063
 98,228        121,063       131,693       121,063
 131,693       121,063       131,693       87,598
 131,693       87,598        98,228        87,598
 98,228        87,598        98,228        121,063
 99,213        88,583        100,394       88,583
 100,394       88,583        100,394       89,764
 100,394       89,764        99,213        89,764
 99,213        89,764        99,213        88,583
 99,213        118,898       100,394       118,898
 100,394       118,898       100,394       120,079
 100,394       120,079       99,213        120,079
 99,213        120,079       99,213        118,898
 129,528       118,898       130,709       118,898
 130,709       118,898       130,709       120,079
 130,709       120,079       129,528       120,079
 129,528       120,079       129,528       118,898
 129,528       88,583        130,709       88,583
 130,709       88,583        130,709       89,764
 130,709       89,764        129,528       89,764
 129,528       89,764        129,528       88,583
-55,118        231,89       -56,496        229,724
-56,496        229,724      -56,496        208,858
-56,496        208,858      -55,118        207,087
-26,772        151,299      -25,591        151,299
-25,591        151,299      -25,591        150,118
-25,591        150,118      -26,772        150,118
-26,772        151,299      -26,772        150,118
 3,346         151,299       4,528         151,299
 4,528         151,299       4,528         150,118
 4,528         150,118       3,346         150,118
 3,346         151,299       3,346         150,118
-26,772        120,984      -25,591        120,984
-25,591        120,984      -25,591        119,803
-25,591        119,803      -26,772        119,803
-26,772        120,984      -26,772        119,803
 3,346         120,984       4,528         120,984
 4,528         120,984       4,528         119,803
 4,528         119,803       3,346         119,803
 3,346         120,984       3,346         119,803
 39,646        369,488       39,646        375
 39,646        375           45,158        375
 45,158        375           45,158        369,488
 45,158        369,488       39,646        369,488
 45,554        212,598       45,554        206,693
 45,554        206,693       39,648        206,693
 39,648        206,693       39,648        212,598
 39,648        212,598       45,554        212,598
 45,559        57,284        45,559        51,378
 45,559        51,378        39,653        51,378
 39,653        51,378        39,653        57,284
 39,653        57,284        45,559        57,284
